Віктор Перунський | Перунський
Віталік Кремінь | Кремінь | Віталій Кремінь
Тарас Стадницький | Стадницький | Тараса Стадницького
Андрій Озарків | Озарків
Андрій Сенч | Сенч
Сашко Лопушанський | Лопушанський
Коля Капішон | Капішон
Колін Кубік | Кубік
Влад Данкевич | Данкевич
Юля Різничок | Різничок
Юра Пронюк | Пронюк
Олег Лузанов | Лузанов
Олег Грюндік | Грюндік
Вадим Ковалик | Ковалик
Вадим Кириленко | Кириленко
Діма Сушевський | Сушевський
Ерідан Ізмерлі | Ізмерлі
Ірина Левкун | Левкун
Михайло Попʼюк | Попʼюк
Роксана Тимків | Тимків
Макс Вишинський | Вишинський
Макс Гіль | Гіль
Роман Храменков | Храменков
Роман Мельник | Мельник
Роман Щур | Щур
Вова Євчук | ВОВА ЄВЧУК | Володимир Євчук
Свєта Немонежина | Немонежина
Святослав Антіпов | Антіпов
Сашко Чернологов | Чернологов
Ярослав Пірог | Пірог
Альберт Лалаян | Лалаян
Оля Клінова | Клінова
Настя Сіль | Сіль
Богдан Вахнич | Вахнич
Олександр Дмитрович | Дмитрович
Вадим Дзюнько | Дзюнько
Валерія Михайлова | Михайлова
Максим Кравець | Кравець
Ігор Рапіта | Рапіта
Ігор Нерівний | Нерівний
Марина Войцеховська | Войцеховська
Таня Кудрява | Кудрява
Катя Олос | Олос
Артем Лиман | Лиман
Арсен Пучков | Пучков
Свят Марченко | Марченко
Роман Небо | Небо
Ліля Панчишин | Панчишин
Паша Євчук | Паша Євчук
Валентин Перуз | Перуз
Євген Назаренко | Назаренко
Олексій Приймаченко | Приймаченко | Олексій Приймаченко
Слава Бу | Бу
Макс Лопахтін | Лопахтін
Льоня Тору | Тору
Житняк | Житняк
Руслан Колесник | Колесник
Богдан Боярин | Боярин
Алла Волкова | Волкова
Паша Пінчук | Пінчук | Павло Пінчук
Ден Че | Ден Че
Марк Свиридюк | Свиридюк
Данило Повар | Повар | Повар Даніл
Богдан Богаченко | Богаченко
Андрій Пілат | Пілат
Ануар Айяд | Айяд
Вова Маслов | Маслов
Вєста Гунченко | Гунченко | Вєста Гунченко
Ігнат Михайлюк | Михайлюк
Кирило Гузій | Гузій
Богдан Письменко | Письменко
Саша Качура | Качура
Женя Євсюков | Євсюков | Євген Євсюков
Катя Федоркова | Федоркова
Джейхун Сафаров | Сафаров
Настя Зухвала | Зухвала
Сергій Ліпко | Ліпко
Антон Тимошенко | Тимошенко | Anton Tymoshenko
Нікіта Трандафілов | Трандафілов | Микита Трандафілов
Антон Сенін | Сенін
Свят Загайкевич | Загайкевич
Лана Чубаха | Чубаха
Єгор Шатайло | Шатайло
Сергій Чирков | Чирков
Артур Петров | Петров
Антон Стенюк | Стенюк
Ганна Кочегура | Кочегура | Анна Кочегура
Сергій Степанисько | Степанисько
Василь Байдак | Байдак | Вася Байдак
Олександр Жипецький | Жипецький
Юра Коломієць | Коломієць
Ірина Гіль | Гіль
Дмитро Білоус | Білоус
Женя Коротков | Коротков
Сергій Афонський | Афонський
Володимир Жогло | Жогло
Олексій Ральніков | Ральніков
Тарас Яремій | Яремій
Славік Мартинюк | Мартинюк | Ярослав Мартинюк | Славіка
Дімка Носов | Діма Носов | Носов | Дмитро Носов
Наталі Скорик | Скорик
Фелікс Редька | Редька | Феликс Редька | Фелікса Редьки
Іван Жорноклей | Жорноклей | Жорноклей
Сергій Громовий | Громовий | Громовий
Максим Давиденко | Давиденко
Сергій Сидоров | Сидоров
Олесь Синьога | Синьога
Дмитро Тютюн | Тютюн
Костя Ташаков | Ташаков
Влад Солонський | Солонський
Стас Ваплюшкін | Ваплюшкін
Денис Корабльов | Корабльов
Максим Величко | Величко
Іван Столяревський | Столяревський
Денис Горобець | Горобець
Міша Мартинчук | Мартинчук
Михайло Буслаєв | Буслаєв
Раміль Янгулов | Янгулов
Костянтин Ізюмов | Ізюмов
Влад Бивалін | Бивалін
Антон Болдирев | Болдирев
Микита Алєксєєв | Алєксєєв | Алексеев | Nikita Alekseev
Олесь Пінчук
Богдан Письменко | Письменко
Євген Лещенко | Лещенко
Максим Мельников | Мельников
Микита Олексієв | Олексієв
Андрій Бережко | Бережко
Макс Лопахтін
Василь Бор
Микола Житняк | Миколи Житняк | Житняк
Влад Морозов
Валерія Мандзюк | Лєра Мандзюк | Мандзюк
